User_name,Follower_count(F1),M4,RT3,RP3,Acquaintance_score
adotinthedark,62,0,72,3,137
AdrianMLevy,2085,0,801,9,2895
Ads64in,620,0,23,0,643
Adultjoks,19,0,76,0,95
AdvaitNemlekar,338,0,192,15,545
advantageperf,9390,0,56,0,9446
advocateghumman,1632,0,1017,0,2649
AdvocateSabita,188,0,532,3,723
aeetz06,111,0,1078,2,1191
AegisSchool,411,0,280,2,693
aehaque,673,0,714,3,1390
aelshemy16,731,0,99,2,832
AeroSquadra,11655,0,316,37,12008
afdhal_id,1426,0,28,0,1454
Affanyousuf9,551,0,680,2,1233
affiliatebiz,2949,0,278,0,3227
afgao,1489,1,756,9,2255
afzal_57,275922,0,5,71,275998
agarwaledu,15221,0,259,5,15485
agawley,1206,0,191,14,1411
agbrolo,1366,0,284,23,1673
agentinsolent,672,0,230,0,902
AgentPete,2891,0,79,0,2970
AgGenomicsGuy,432,0,391,29,852
AghaShaahidAli,34227,0,359,9,34595
agitzade,13670,0,19,3,13692
agnimitra2026,254,0,126,1,381
Agos_Daniella,1577,0,642,50,2269
AGraynor,28765,0,302,1,29068
Agustinporres,2497,0,810,5,3312
AhamedHassanMP,842,0,888,14,1744
ahiliyanat,248,0,596,3,847
ahishor,538,1,850,0,1389
AhluwaliaSaheb,148,0,727,6,881
ahmedmakda_am,71,0,139,76,286
AHPBA,3937,0,603,8,4548
Ahsanafaq22,148,0,629,3,780
AhujaReva,134,0,381,2,517
Ai4Youth,903,0,565,29,1497
AiglonCollege,1540,0,87,1,1628
AIgorithmIA,3270,0,247,47,3564
aikhwaja,20361,0,408,62,20831
AilleneRuby,11415,0,173,0,11588
AinedeSousa,11123,0,135,2,11260
ainhopia,273,0,1259,9,1541
airudit,579,0,837,4,1420
AishPaliwal,7199,0,139,44,7382
aisrao,1688,0,384,69,2141
aitreainichairm,1900,0,31,0,1931
aiu_athletics,5937,0,129,59,6125
AI_ilachinski,584,0,988,0,1572
ajaeybjp,25920,0,159,42,26121
ajai3830,336,0,60,0,396
ajanayak,367,0,163,13,543
ajaybharadwaj,560,0,259,9,828
ajayc47,730,0,239,3,972
ajayekal,441,0,23,6,470
Ajaygaurbjpfbd,1788,0,890,23,2701
ajayjamwalRSS,3165,0,818,0,3983
ajayPspeak,178,0,452,18,648
ajayr1993,332,0,1028,3,1363
ajaysamson,663,0,161,9,833
AjaySinghNegi,1094,0,1061,0,2155
ajay_shah,6808,0,6,0,6814
AJAZ_ALI_ANSARI,735,0,1067,0,1802
ajfoley,4018,0,460,2,4480
AjitaShashidhar,1838,0,206,2,2046
ajmizner,127,0,284,57,468
ajoydada,78,0,62,34,174
AjuVarghesee,647732,1,168,0,647901
akaGJS,966,0,975,4,1945
AkankshaSingh4,11470,0,229,7,11706
Akanksha_1009,616,0,341,18,975
akanshaarneja,3593,0,195,20,3808
akasha63,843,0,326,1,1170
akash_lightblue,979,0,24,4,1007
akasomeguy,5361,3,237,20,5621
akbardalai,651,0,301,100,1052
akc4karnal,2118,0,0,0,2118
AKGarg93,5689,0,573,11,6273
AkhilBansalKPMG,2413,0,605,9,3027
AkhilNasha,4742,1,166,117,5026
akhilreni_hs,3323,1,351,169,3844
Akjpatt,29454,0,212,0,29666
AKMetoikos,934,0,201,43,1178
akoserwal,317,0,510,9,836
akpk_in,212,0,795,2,1009
AKQA,91112,0,45,1,91158
akritita,298,0,348,10,656
AkritiTyagiNDTV,165,0,1035,1,1201
akrit_michael,783,0,103,31,917
akshaykomar,155,0,0,1,156
akshayprabhu_,233,0,503,16,752
akshayravi999,273,0,213,1,487
akshayxk,567,0,369,22,958
Akshhaya_R,89,0,710,12,811
AksshitWadhwa,385,0,55,2,442
aktiwaryssa,135,0,826,6,967
akujad,5847,0,616,5,6468
akumar2408,804,0,293,71,1168
alaamaliik,239,0,76,8,323
AlaapG,995,0,1147,1,2143
AlabedBana,290189,1,142,5,290337
alacon,1066,0,210,34,1310
alain_berset,157634,0,370,1,158005
alambains,316,0,1083,0,1399
alanfgates,6198,1,818,2,7019
AlankarSawai,10125,0,1126,0,11251
albertw,540,0,239,1,780
alcinojsilva,4607,0,937,1,5545
aldawood_ali,180,0,750,3,933
AlderweireldTob,703259,0,109,4,703372
AleAndooo,191,0,82,1,274
AleAparicio13,231,0,73,6,310
aleemeram53,203,0,240,62,505
AleksibCSGO,63898,0,164,10,64072
alena_scuba,296,0,906,0,1202
Alescent,6694,0,682,0,7376
alexa99,1356634,1,79,47,1356761
AlexaGrasso,48469,0,754,0,49223
AlexanderD_Beck,18962,0,265,0,19227
alexanderlhayes,255,0,340,59,654
alexheid,15581,0,805,1,16387
alexiwobi,839256,0,68,0,839324
alexmiller73,4962,0,122,1,5085
alexpersat,908,0,762,68,1738
AlexWelcing,493,0,165,38,696
AlexWhitcomb,128336,0,328,86,128750
Alex_Salikov,315,0,1185,1,1501
Alex_Scdr,452,0,381,0,833
alex_seryj,657,0,709,0,1366
Alex__Muller,123,0,126,7,256
alfamale1516,107,0,1071,0,1178
alfiaar1,279,0,865,37,1181
algolytics,1676,0,348,1,2025
AlgoRhythmm,365,0,1536,0,1901
ali01,15721,0,286,433,16440
AliceMarieFree,31005,0,715,10,31730
ALIMCOHQ,1226,0,1076,2,2304
alimelloul,494,0,407,6,907
AlinB_ManUtd,102,0,513,2,617
AlishaSofficial,20929,0,161,13,21103
AlisonCRollins,2259,0,275,45,2579
AlisonGopnik,12382,0,408,11,12801
aliyyashelley,4403,0,565,1,4969
Ali_a6165,60963,0,541,2,61506
ali_a_zaidi,11916,0,980,70,12966
AljiraTweets,617,0,76,0,693
allanao,3313,1,295,41,3650
AlliaAR,5415,0,178,0,5593
alliance4ai,1048,0,432,861,2341
AllieHilmer,1614,0,485,1,2100
AllstarsFC_PFH,3911,0,155,18,4084
allthingsAyesha,768,0,385,5,1158
alma_perdida5,687,0,283,2,972
almousawi,588,0,479,16,1083
alokcreovate,1110,0,50,5,1165
AlokKrishnan,120,0,46,0,166
alonamarie,1857,1,289,117,2264
alonso_inaki,2759,0,508,1,3268
altlawforum,5044,1,168,45,5258
AltnokBesim,4331,0,495,29,4855
AlvandSalehi,1401,1,668,1,2071
AlvaroNegredo9,721454,0,291,1,721746
alvin_vista,217,0,51,27,295
AlwaysJani,86775,1,126,33,86935
Always_A_Hit,893,0,528,1,1422
alyciakaback,6944,0,224,0,7168
Alyonakapoor,2006,0,988,0,2994
AlyssaMendonsa,830,0,219,16,1065
AlzahraKhawla,716,0,1150,0,1866
AMacOSTP,2394,1,810,98,3303
amandajparkes,2502,0,483,1,2986
amandeepbet,119,0,928,1,1048
amankhan77,395,0,345,1,741
Aman_Naimat,1589,0,474,3,2066
Aman_sal,1174,0,995,55,2224
AmarAmar36,297,0,823,3,1123
amarmohile,398,0,170,0,568
Amar_Shukla_inc,289,0,368,0,657
Amazingauto5758,1323,0,912,8,2243
ambassey,2185,0,572,9,2766
AmbaVashishth,53,0,0,3,56
ambikamahajan,1687,0,53,1,1741
ambjr,209,0,593,2,804
AmbujaMall,771,0,284,0,1055
ameeyajnik,1482,0,998,1,2481
AmerShoib,528,0,0,1,529
Amey_Ghatge,438,0,79,0,517
AMGSMadrid,398,0,409,4,811
Amiekhane,194,0,87,0,281
amilliewaadia,405,0,303,3,711
aminashervani,792,0,660,90,1542
amineshjain,2289,0,632,2,2923
AmishaModi,832,1,589,13,1435
Amit9716685822,189,0,1191,0,1380
amitabhabagchi,486,1,330,10,827
amitabhdelhi,976,0,64,1,1041
amitabh_pathak,11,0,12,72,95
AmitAsharStudio,2883,0,203,8,3094
amitava8,578,0,1012,3,1593
amitbasole,2095,0,244,200,2539
Amitbhandari110,10753,0,677,2,11432
AmitChandrra,415,0,804,0,1219
AmitDCR,54,0,759,13,826
AmithHegde6,11070,0,41,13,11124
Amitjit79,315,0,272,0,587
amitmajor,420,0,34,3,457
AmitParalympian,3849,0,297,7,4153
amit_agrawal13,1733,0,297,77,2107
amit_azm,422,0,1075,0,1497
amit_prasher1,5520,1,471,4,5996
AmJSurgery,12164,0,333,211,12708
amnamatrafi,361,0,925,2,1288
amnasingh,228,0,857,2,1087
amn_g,310,0,334,4,648
Amolik_Aujla,546,0,823,1,1370
amolmitkari22,119122,1,162,29,119314
amolsharma99,474,0,363,35,872
amor_rb7,160,0,44,0,204
ampareenlyngdoh,3914,0,446,67,4427
AmritSagar,701,0,1060,0,1761
amSunitha,481,0,844,12,1337
Amtrox,508,0,254,23,785
amuarora,369569,0,197,1,369767
amyhodler,1301,0,220,10,1531
amyketu,123,0,674,9,806
AmySatterthwait,11297,0,408,0,11705
amysundae,27356,1,124,121,27602
AM_Deepuuuu,107,0,242,15,364
AnaBotin,49247,0,46,275,49568
anacarla1975,752,0,979,2,1733
anahas8,650,0,608,6,1264
AnaLauraRS,312,0,332,101,745
AnalyticMike,2378,0,41,3,2422
anandahuja,13048,1,393,17,13459
anandiisme,137,0,87,3,227
Anandraipti,2749,0,85,8,2842
anandshukla1987,361,0,102,14,477
anandsinha3,982,0,687,21,1690
anandtiwarics,989,0,1072,13,2074
Anand_datta,1917,0,84,37,2038
ananthan_TOI,86,0,11,0,97
ananthmani,543,0,230,8,781
ananthn1,191,0,915,3,1109
ANANTRAMAN,95,0,713,3,811
anantsudarshan,770,0,400,33,1203
AnanyaPanda,443,0,645,0,1088
ananya_goenka,11483,0,147,13,11643
anchalk,7792,0,355,6,8153
anchorrandeep,162,0,155,5,322
AndersonBrian01,4117,0,220,0,4337
andersoncathl,1045,0,239,2,1286
andi_mtc,19818,0,1551,0,21369
andjanlund,590,0,644,29,1263
andradeandrey,6155,0,312,1,6468
AndreaHawksley,1072,0,412,77,1561
andreas7812,358,0,836,10,1204
andreasartori94,2051,0,387,14,2452
AndreaSmithCLT,4553,0,377,0,4930
andreasomberg,20228,0,369,1,20598
andrea_w3010,1485,0,198,4,1687
AndreBegemann,1822,0,268,1,2091
andrejg_au,1064,0,119,0,1183
andresparrado63,336,0,566,28,930
andrewdreyfus,1173,0,468,0,1641
AndrewHolmes82,2341,0,298,13,2652
AndrewLeifer,1176,0,1020,26,2222
AndrewM_Webb,14174,0,32,509,14715
AndrewsAmelia,305,0,697,4,1006
andrewsangs,348,0,621,1,970
AndrewSmithHQ,1024,0,176,0,1200
andrewtibbitts,1224,0,973,4,2201
Andre_Schuerrle,1889061,0,452,1,1889514
AndyBhaduri,1443,0,417,2,1862
Andygamble66,376,0,496,4,876
andymcdonald2,2758,0,433,0,3191
andyrobbins,1149,0,293,1,1443
AndyzDuniya,535,0,97,20,652
aneelb,23181,1,636,0,23818
AneeshaSahni,502,0,609,1,1112
aneeshs,2220,0,250,18,2488
Angadluthra,119,0,81,41,241
AngelaFresne,616,0,274,2,892
AngelaTuminello,3968,0,538,0,4506
Angelo69Mathews,404890,0,123,1,405014
AngieS912,809,0,795,3,1607
angjiang,24854,0,15,35,24904
AnglianMG,206,0,173,13,392
aniket__18,117,0,654,3,774
AnilAgarwal_Ved,91989,0,200,141,92330
Anildogra007,174,0,421,1,596
AnilHem,60,0,32,0,92
AnilKokil,2157,0,335,135,2627
anilpsori,433,0,1192,40,1665
anilsainiAC57,1242,0,1180,0,2422
anil_2030,429,0,157,30,616
anil_jain_bjp,517,0,71,52,640
animeshjain,412,0,166,6,584
aninditaces,568,0,405,12,985
anindya55,87,0,45,81,213
ANINDYAtimes,1396,0,951,4,2351
anirbangolf,12226,1,342,10,12579
AnirbanRoy_CPIM,69,0,288,0,357
anishjoag,611,0,459,0,1070
AnishRaivadera,785,0,90,0,875
anistartup,911,0,486,6,1403
AnitaChung4,368,0,257,7,632
anitaokoester,1498,0,476,9,1983
anita_mukherjee,2001,0,687,31,2719
ani_nenkova,3274,0,182,176,3632
AnjaBotswana,1959,0,74,43,2076
anjaliadoshi,5387,0,316,1,5704
AnjaliKing,290,0,724,4,1018
AnjaliMenonFilm,462439,0,238,11,462688
Anjalinarrative,772,0,83,1,856
AnjalPrakash,1268,0,849,5,2122
anjauhlendorff,535,0,493,21,1049
anjela_taneja,989,0,74,712,1775
Anjit_S_Rajput,1434,0,855,14,2303
ankitag1186,1342,0,429,20,1791
AnkitaNDTV,6293,0,214,3,6510
Ankita_13Jha,636,1,175,42,854
AnkitDuseja,401,0,176,34,611
AnkitNDT,13974,0,706,17,14697
AnkitPahwa,146,0,611,2,759
ankitsingh_IPS,10131,0,914,0,11045
ankit_bhonde,59,0,514,7,580
AnkurK_17,129,0,552,9,690
AnkurSanatani,401,0,1132,0,1533
ankurt,517,0,548,1,1066
Ankur_IIS,2648,1,201,31,2881
ANKUSH_00007,8740,0,253,7,9000
anmolkjha,309,0,1363,4,1676
annadudich,913,0,799,0,1712
AnnaKFaris,490671,1,346,15,491033
AnnaLysyanskaya,1897,0,377,82,2356
annamalai_k,165052,0,259,143,165454
annastirr,1971,0,515,26,2512
AnneFulenwider,9664,0,274,4,9942
AnneMCaulfield,5236,0,717,11,5964
AnneSpevack,165,0,610,175,950
anniecase1,7967,1,223,6,8197
AnnieMorrisonMD,1777,0,295,19,2091
anniepanter,2213,0,115,0,2328
anniepolland,1052,0,885,1,1938
AnnisaSLestari,232,0,0,0,232
anothersy_,309,0,160,8,477
AnsariNsaher,182,0,1042,4,1228
anshugoonj,7732,0,330,5,8067
anshul95varma,247,0,715,1,963
anshumonsharma,10039,0,29,34,10102
ant4g0nist,863,0,549,12,1424
AntDLewis,513,0,308,56,877
anthem_comics,16691,0,348,0,17039
anthonydolan_,978,0,111,5,1094
AntillaJon,343,0,3,40,386
AntiqueLyrics,12569,0,34,0,12603
anu1905,728,0,304,77,1109
anubhav_daksh,234,0,179,2,415
Anuchitikineni,508,0,793,5,1306
AnujKum78520129,44,0,171,1,216
anunaya_j,16076,0,818,12,16906
anupamaraag1,8360,0,138,6,8504
AnupamSibal,2090,0,130,37,2257
anupap85,235,1,589,27,852
anupjerajani,271,0,112,17,400
anupria_goenka,10471,2,593,2,11068
anuprubens,376145,2,829,1,376977
AnuradhaBhasin_,10613,0,375,65,11053
anuradhar,356,0,33,0,389
Anurag131,193,0,447,7,647
AnuragAgrawalMD,2578,2,502,42,3124
anuraggangal,232,0,283,21,536
anuragrao123,4439,1,482,1,4923
anuragyadav107,144,0,40,12,196
anushkafernando,348,0,359,6,713
anushka_menon,3175,0,50,4,3229
Anushka_Rajan,8530,0,211,3,8744
anushreeAmehta,1049,1,428,2,1480
anwarzs,707,1,901,2,1611
anyarangaswami,1794,0,83,4,1881
AnyaShankar,2780,0,852,102,3734
Anya_shrubsole,28266,1,135,1,28403
ANZCA_FPM,1186,0,739,5,1930
aocsa,322,0,507,3,832
aolarerin,126,0,906,14,1046
APACinfosec,720,0,85,11,816
APanagariya,93969,2,669,15,94655
AparnaaBajpai,3519,0,417,4,3940
Aparnabadlani,2524,0,188,0,2712
AparnaRaghu1,355,0,918,0,1273
aparnasharma68,191,0,468,37,696
APBioNetorg,441,0,245,7,693
apburden,5688,0,622,1,6311
Apex_Nikki,384,0,113,9,506
AphMohammadi,1382,0,522,12,1916
apinthehouse,42,0,692,23,757
api_university,6550,0,161,0,6711
apkaVijay,4137,0,661,0,4798
apollodiag,1874,0,9,5,1888
Appledystopia,623,0,55,1,679
AppugoudaPatil,9765,0,75,10,9850
aprajita1998,47,0,923,4,974
AprajitaSarangi,131728,0,148,43,131919
aprasahney,819,0,821,1,1641
AprilSixGlobal,990,0,187,7,1184
AprilStuck,259,0,108,0,367
AprylW,2266,0,609,29,2904
ApunHiAsliHai,83,0,50,5,138
apurwhoa,117,0,238,5,360
ap_behera,3718,0,1214,4,4936
ap_itec,4743,0,376,2,5121
AquaGeneral,136,0,443,144,723
ArabYouthSurvey,11537,0,426,32,11995
aracelisxgirmay,4151,1,488,26,4666
Aradhanashish,134,0,681,0,815
ArakaliHari,1006,0,316,1,1323
arasibhaibarad,1251,0,16,3,1270
aratisingh2000,542,0,253,1,796
aravikiran,752,0,109,9,870
ArbalestPartner,17160,0,231,2,17393
ArbourVW,106,0,135,0,241
Archanapsp,1233,0,132,14,1379
ArchanaRSingh,511,0,102,1,614
archanas1003,7285,0,654,1,7940
Archana_Kochhar,15874,2,167,18,16061
archiepanjabi,39483,0,269,7,39759
architHM,185,0,450,10,645
ArchsEngage,662,0,525,19,1206
ardemp,2875,1,254,46,3176
are_vee,180,0,227,21,428
ARfrom1947,6143,0,46,13,6202
arghya_majila,112,0,1175,1,1288
ari29jit,687,0,347,0,1034
ArihaSetalvad,581,0,396,5,982
AristocratBags,9263,0,6,4,9273
aritamukherjee,536,0,324,18,878
arivukal,1350,0,61,21,1432
ArjunMaini,3311,0,896,21,4228
ARJUNMATHUR7,64,0,1093,7,1164
arjunmk1,466,0,69,74,609
arjunskumar,340,0,170,15,525
arkamukherjee,5619,0,23,0,5642
arka_das,475,1,271,36,783
ArknightsEN,176713,0,3,21,176737
ArknightsStaff,448780,0,182,52,449014
ARKyuvi,313,0,716,1,1030
Armaalianakku1,108,0,64,2,174
Armaalian_being,380,0,121,2,503
armaalian_Sarah,64,0,539,8,611
armaancrockroax,8339,1,586,20,8946
armaanian_4life,228,0,244,22,494
ArmaanIsLife,162,0,448,17,627
armaanmplanet,134,0,43,16,193
ArmaanVananchal,954,0,166,12,1132
Armaan_Loverz,258,0,903,0,1161
armacdowell,913,0,312,2,1227
ArmentaArce,3150,0,62,0,3212
armiehammer,380490,0,60,47,380597
ArnabGofficial7,423223,0,826,0,424049
arnav_kumar,5876,0,231,179,6286
arnikathakur,662,0,639,7,1308
aroybot,46084,0,602,3,46689
arpan_vohra,287,0,268,2,557
arpita_bisht,248,0,1192,2,1442
arpitmishra_06,39,0,795,4,838
Arrelic_,3443,0,649,39,4131
Arresai,904,0,810,2,1716
ArrojadoBR,13161,0,197,31,13389
arsavium,3098,0,353,21,3472
ArshaCharmar,416,0,495,9,920
Arshionista,950,0,104,7,1061
arshiyauzma,339,0,372,2,713
Arshiya_Syed11,120,0,837,0,957
arshukla,2039,1,294,71,2405
art0flunam00n,457,0,1123,7,1587
art4youIreland,3851,0,2,0,3853
ArtDecoImages4D,34778,0,927,5,35710
ArtiSinghRao,4623,1,378,53,5055
artistJabu,31909,0,45,4,31958
ArtItNow1,113883,0,1127,0,115010
ARTPOP_NEW_ERA,740,0,206,0,946
ArtSouthAsia,2737,0,700,2,3439
ArunachalTsm,10498,1,620,4,11123
arunaugustine,539,0,373,42,954
arunavamandal,528,0,795,0,1323
arunbajee,415,0,124,1,540
arunbpbjp,2724,0,736,3,3463
ArunDManimal,469,0,646,8,1123
aruninside,302,0,13,9,324
arunp2810,15395,1,218,10,15624
ArunVoraMLA,8242,0,343,3,8588
Arup91043899,110,0,1508,0,1618
ArushiNishank,9173,0,240,133,9546
arvindagarwalla,781,0,102,2,885
