username,Follower_count(F1),M4,RT3,RP3,Acquaintance_score
gailcollins,63516,0,651803037,5,651866558
rahul_sen,265,0,41776405,191,41776861
andrinhopereira,1097191,3,38940225,7,40037426
RobertIger,243596,4,33209709,63,33453372
aneeshabaig,2386,1,28487856,10,28490253
deepikapadukone,27623138,67,634606,30,28257841
shawndolley,647,0,28034872,41,28035560
PathRuzCaracuel,1073,0,24760720,685,24762478
SopanDeb,175285,0,20440009,35,20615329
BabyBearHS,8221,1,20477245,528,20485995
emelisande,1010452,1,18527445,32,19537930
Director_SEZ,34203,1,19086306,47,19120557
prasoonjoshi_,138682,10,18711690,2,18850384
NarendraPatil63,210,0,18130712,3,18130925
SirBobbyDeol,33619,0,17629409,9,17663037
RobertDowneyJr,17252890,8,14657,78,17267633
tomhanks,16334963,13,311430,40,16646446
BobPickard,93656,0,15529802,8,15623466
Saurabhsays_,428,0,13959128,1,13959557
XabiAlonso,11672984,3,209153,4,11882144
paulpogba,9881722,14,1864397,298,11746431
ck8860,3893,0,11586096,873,11590862
IssaRae,1640569,2,9711799,13,11352383
SeenuMohapatra,923,0,10838818,8,10839749
reba,2340433,0,7828596,7,10169036
mikeflannagan,1795,0,9663961,477,9666233
Persie_Official,9339471,7,33771,1,9373250
NPR,8935647,36,292976,0,9228659
gjmarx,564,0,8955829,16,8956409
SteveMartinToGo,8741870,2,13222,0,8755094
BryanCranston,2189792,4,6111494,11,8301301
Ibra_official,8009772,12,127974,4,8137762
lderevnina,580,0,7885415,153,7886148
surajdidwania,576,0,7733559,1,7734136
icann_president,19621,0,7665525,30,7685176
sbhalla6,323,0,7630218,51,7630592
JordiAlba,2454153,1,4828442,53,7282649
OriolVinyalsML,112404,3,7062612,23,7175042
allenthehun,7989,0,7148172,25,7156186
kcpatelbjpguj,18674,1,6917629,455,6936759
RishabhPant17,3226294,15,3255056,13,6481378
vishalrajfilms,649,0,6439906,3,6440558
governorswaraj,48380,4,6391493,132,6440009
SGanguly99,6196462,39,143412,80,6339993
jimsinai,1965,0,6295204,29,6297198
AdityaDharFilms,19130,6,6231477,4,6250617
smarket,25405,0,6180251,3,6205659
Zakirism,1232041,7,4956332,7,6188387
dannyjeffers,11644,0,5906796,354,5918794
iamjohnoliver,5727182,6,178234,41,5905463
ItamarCareca,10514,0,5787860,13,5798387
DrSailajaK,894,0,5730748,0,5731642
pushpanarayan,2742,2,5699619,370,5702733
menongautham,3665856,7,2019930,133,5685926
Bnassir,808,0,5684107,9,5684924
jeffhiro,2644,0,5452472,5,5455121
uditprakash,11056,1,5355497,4,5366558
Jaspritbumrah93,4776459,24,547838,3,5324324
SushilModi,2228245,17,2915644,31,5143937
el_mago_oficial,1245176,1,3885010,6,5130193
GEJonathan,1691529,1,3358639,30,5050199
jaketapper,3342771,10,1706805,6,5049592
RadiNabulsi,59624,0,4961787,40,5021451
robmeadows,17115,0,4972268,51,4989434
sakshijain23_,203,0,4987160,7,4987370
lisa_singh71,382,0,4979049,42,4979473
_Pedro17_,4864259,1,98800,98,4963158
sahartwitt,1259,0,4959192,64,4960515
landondonovan,1300609,3,3624018,130,4924760
NotAltWorld,988335,0,3922250,230,4910815
atul_deshkar,1017,0,4826243,6,4827266
duttsanjay,2676946,15,2065637,6,4742604
HarleenParmar,42858,0,4692407,25,4735290
TrentAA,2094722,0,2570814,1,4665537
rohinthampi,632,0,4562745,1192,4564569
AwkwardMuslim,84462,0,4474971,1,4559434
Dir_Lokesh,1378342,6,3049108,113,4427569
ylogx,471,0,4411883,23,4412377
EvelynRusli,39781,1,4366926,2,4406710
gokul_rgk_05,105,0,4358379,6,4358490
CEFreitagMD,676,0,4346053,11,4346740
iamhariomsrk,333,0,4271976,0,4272309
sranjitETIG,2295,0,4245180,6,4247481
EP_President,300642,2,3944763,0,4245407
Honorglobal,252949,1,3986889,396,4240235
rlyadavofficial,698,0,4211375,205,4212278
nastass2,446,0,4192396,6,4192848
rsg,75313,4,4086303,37,4161657
JackWilshere,3694037,8,450334,0,4144379
AnnCoulter,2040801,1,2089210,584,4130596
JesseLingard,2909924,5,1199194,70,4109193
DAVID_LYNCH,3287299,2,796531,12,4083844
AdamSandler,2996553,2,979085,10,3975650
Syamant,3679,1,3960520,221,3964421
TheCriclife,1237,1,3895709,8,3896955
dustinvtran,33873,1,3856229,238,3890341
BeingKohlicious,1900,0,3873824,6,3875730
manitpradeep007,256,0,3853053,586,3853895
GloriaSteinem,363984,4,3467993,18,3831999
AydenLincoln,12723,0,3783553,512,3796788
youngy18,2664323,7,1079531,101,3743962
Chanakya_7,30,0,3724956,10,3724996
itsmeleighton,1600891,0,2112962,869,3714722
RahulMaganti,356,0,3713208,80,3713644
jephoi23,2745,0,3654461,79,3657285
tmyerson,27765,0,3621143,124,3649032
ADFFilms,17233,3,3581620,2,3598858
reecha_sinha,898,0,3563482,16,3564396
TrentWoodhill,22719,2,3517053,2633,3542407
Woslove,1660,0,3523022,12,3524694
younessb5,800,0,3489211,7,3490018
tanuja_kothiyal,1219,0,3413885,517,3415621
Retweetologist,10561,0,3389888,32,3400481
vinijr,2659867,1,728666,74,3388608
delpotrojuan,3277840,3,107375,2,3385220
sourish_m,509,0,3372812,5,3373326
Sarikaasharma,689,0,3352937,2,3353628
CRJCrawfordNZ,1107,0,3264538,10,3265655
VirgilvDijk,2812382,6,442552,6,3254946
kathanmunshi,204,0,3245703,36,3245943
sanjaysinghjdu,14793,1,3184928,0,3199722
newsflicks,60439,0,3131342,72,3191853
beatsbydre,912270,8,2276724,8,3189010
TracyMorgan,2823213,0,336651,13,3159877
dogecoin,3127806,2,16477,462,3144747
LazyHippogriff,68,0,3134058,30,3134156
Malala,2033774,25,1098944,2,3132745
Inc42,33569,9,3094055,139,3127772
abdur,180727,0,2882670,1,3063398
JesseLakes,420,0,3058068,4,3058492
sussannekroshan,574897,3,2453402,86,3028388
_OlivierGiroud_,2823882,10,196935,135,3020962
fbrandtips,45389,0,2956230,16,3001635
IoTNext,878,1,2999502,11,3000392
shibangiSR,1596,0,2985796,32,2987424
Alexis_Sanchez,2910803,7,58494,51,2969355
maanayata_dutt,49181,2,2902839,10,2952032
andrewrsorkin,908193,5,2041710,24,2949932
y_umesh,2817757,14,128153,0,2945924
itznehamalik,710,0,2942402,0,2943112
AvtarFateh,1682,0,2936131,23,2937836
JheneAiko,2841526,0,75975,793,2918294
RiversCuomo,1129982,0,1782792,769,2913543
ProFootballTalk,1768115,0,1133025,463,2901603
pschiller,266563,0,2628329,7,2894899
FabienForest,885,0,2877127,30,2878042
ManushiChhillar,297601,13,2563257,771,2861642
adamdangelo,56025,2,2790781,19,2846827
Phil_Coutinho,2079067,2,756906,33,2836008
MrAncelotti,2732656,3,99279,69,2832007
AwkashGarg,1052,0,2806327,344,2807723
ibogost,108802,3,2669136,197,2778138
cheteshwar1,2747625,26,7618,2,2755271
tweetsauce,1306002,0,1438760,1,2744763
ACAjaccio,116307,1,2621268,20,2737596
The_NewArab,137964,0,2571267,1,2709232
Mayawati,2605190,22,62227,96,2667535
NeilNMukesh,1639183,5,1018443,110,2657741
raenashirali,1844,0,2648336,35,2650215
brbrasseur,102190,0,2525888,198,2628276
IamPathikritB,7244,0,2605047,1,2612292
VinceMcMahon,2469667,0,140264,116,2610047
ChinaRealTime,804222,0,1788965,7,2593194
UdailalAnjana,29810,0,2553424,247,2583481
Sah75official,2084234,2,479261,62,2563559
Fattiemama,1485,0,2503420,21,2504926
EleonoreMayola,2304,0,2496500,50,2498854
jetsetter,1150,0,2462974,63,2464187
Karthi_Offl,2458362,5,0,2,2458369
orianabandiera,13842,0,2422205,12,2436059
SamNasri19,2388658,1,40492,102,2429253
mayankistwittin,162,0,2419668,161,2419991
MickJagger,2395684,1,356,22,2396063
waqyounis99,2060918,2,300814,4,2361738
Fellaini,2237744,7,122629,38,2360418
dpasker,698,0,2353581,1,2354280
sreewastav,370,0,2340077,15,2340462
ysjagan,2318968,20,20176,1,2339165
Alexortiz1987,13284,0,2312334,4,2325622
sooriofficial,2025600,4,295163,158,2320925
qamrookha7,40,0,2306282,0,2306322
PtRajanSharma,334,0,2305256,217,2305807
theowalcott,2281542,4,22283,711,2304540
theage,940680,2,1360957,2,2301641
VijaySethuOffl,2290746,7,7270,76,2298099
YashwantSinha,234408,12,2007815,228,2242463
binnybansal,66682,2,2142451,12,2209147
SiddharthDeswal,566,1,2206641,3,2207211
SatoshiLite,1070602,3,1122342,4,2192951
puigortoneda,26799,0,2162882,11,2189692
PaulBarba_,8490,0,2162266,8,2170764
heather_desorbo,2510,0,2153355,2,2155867
ghoseb,3444,0,2144831,27,2148302
DennyTapia,2286,0,2127660,17,2129963
shaicohen1,3954,0,2080781,1101,2085836
farmerrf,14354,0,2065544,34,2079932
krunalpandya24,1368270,7,708119,26,2076422
lewy_official,1962597,3,110847,39,2073486
deeptrivedivyas,1025,1,2068379,184,2069589
rohitkbansal,80309,2,1977681,35,2058027
M_Jikurashvili,1311,2,2012893,7,2014213
mornemorkel65,1171578,7,836456,41,2008082
imkuldeep18,1849363,15,136169,496,1986043
a_dc0h,9800,0,1957191,668,1967659
letsencrypt,92493,3,1863236,1,1955733
TickTalkTo,1179,0,1940843,49,1942071
gregoriklosman,63205,0,1832223,15,1895443
ashraysood,895,0,1878111,23,1879029
haristweet,665,0,1874899,17,1875581
Wangchuk66,370331,3,1501683,39,1872056
Himanshimatta,1730,0,1850355,0,1852085
Julian,250294,4,1599247,22,1849567
jay_gurumurthy,139,0,1843801,38,1843978
gZenaida48g,576,0,1811666,94,1812336
ChrisSmalling,1799746,5,9317,27,1809095
CorporatShiksha,948,1,1803043,902,1804894
Takomayuyi,1118305,0,682772,6,1801083
MedelPitbull,1756571,1,42872,98,1799542
ISBInsight,1887,0,1790063,12,1791962
CatChullain,330,0,1780472,0,1780802
hasanzaidisays,594,0,1772607,21,1773222
trevorhlund,197084,0,1569516,145,1766745
AnthonyMackie,1676061,2,88551,20,1764634
LinkedIn,1708381,103,53484,7,1761975
hodgman,1036262,0,713642,2,1749906
JamesMilner,1715655,3,12723,80,1728461
ChandrakalaIas,900867,1,814826,187,1715881
undefinedrocks,254,0,1714169,4,1714427
knowvinay,58,0,1710064,0,1710122
JohnStamos,1684510,3,4529,20,1689062
theblackpanther,1646997,2,31554,86,1678639
KlayThompson,1661237,4,15355,25,1676621
guptajn1001,731,0,1668751,213,1669695
RaviShastriOfc,1648224,14,2160,19,1650417
udaykotak,1149725,3,494013,0,1643741
SWexner,27845,0,1593839,4,1621688
Srinidhi_PR,3574,0,1605504,4,1609082
lenagelis,2234,0,1605527,1,1607762
PrashantJSingh1,809,0,1600881,217,1601907
MartaFdezJurjo,8995,0,1590167,41,1599203
mertesacker,1530955,5,51919,169,1583048
nandibull,1583,1,1575677,1,1577262
bloggingdock,1773,0,1574180,17,1575970
Cyberdost,378950,4,1189250,4,1568208
FELS_SubCon,2476,0,1561085,12,1563573
bradfitz,52340,2,1486937,1478,1540757
SaraRamirez,961931,0,574827,275,1537033
davidaxelrod,1454867,3,75648,622,1531140
GaryJCahill,1269050,2,246487,2,1515541
KotechaDr,135,0,1515386,17,1515538
AndhraPradeshCM,902271,8,607111,22,1509412
ShishirGoUP,134781,2,1374406,38,1509227
RohanWalia14,117,0,1503944,10,1504071
OfficialEl92,1410673,1,92834,205,1503713
realmikefox,1474614,3,24146,1,1498764
alanshoeford,1234,0,1489274,9,1490517
IamSandraOh,1439530,2,46577,0,1486109
VHPeuch,1887,0,1480685,117,1482689
sherryontopp,1042914,16,416883,116,1459929
MishiAmit,1367288,7,90941,71,1458307
TextualOffender,5645,5,1452632,7,1458289
ajinkya78,250,0,1446741,2,1446993
motherofbillis,19562,0,1421286,116,1440964
amlahash,1329547,9,111015,24,1440595
paulinhop8,1395874,0,44031,179,1440084
ShaneRWatson33,1286177,12,152589,8,1438786
dvsukumar,298,0,1435641,80,1436019
AnandSharmaINC,122816,7,1311807,649,1435279
sanjaykanvinde,505,1,1430695,16,1431217
pbmehta,122475,11,1302012,71,1424569
GeoffMosherNFL,62401,0,1353271,29,1415701
match_dekho,71,0,1404590,0,1404661
JitinMakker,440,0,1388359,3,1388802
tabishhk,1792,0,1385893,38,1387723
reach_santosh,6667,0,1356322,25,1363014
DaveSitzler,14327,0,1346813,1245,1362385
masongreenwood,1358781,1,227,5,1359014
mayankcricket,1155883,7,182707,37,1338634
SudhirS96916471,244,0,1326379,36,1326659
sundeepkishan,812619,7,506657,18,1319301
PankajBhardwajS,1395,0,1306596,57,1308048
ivijay79,104,0,1290185,7,1290296
NotFaiz,685,0,1267314,12,1268011
harari_yuval,480239,11,778354,64,1258668
lsanz_iasp,743,0,1256382,2,1257127
LangerPath,1076,1,1252795,1,1253873
CelinaJaitly,998814,2,252678,18,1251512
iamChuckRussell,9090,0,1236701,19,1245810
ch_dharambir,9561,0,1235692,3,1245256
prasantpkm,954,0,1238883,11,1239848
deepak1811,2555,1,1235995,43,1238594
noahcha,190128,0,1044086,0,1234214
ingridvdhburton,1228,0,1232029,0,1233257
bhorowitz,605261,9,613831,6,1219107
MMRAW,120338,0,1091337,46,1211721
EliteDecks,468,0,1209463,0,1209931
SteveAngello,1188920,0,1152,154,1190226
arghya_majila,115,0,1178220,4038,1182373
Bilge_Baak1,46955,0,1130935,1,1177891
AusHCIndia,43726,4,1126180,66,1169976
VictorMoses,1160240,3,2459,15,1162717
StoryTelnHacker,552,1,1152158,157,1152868
thomyorke,1104047,0,44994,1,1149042
ToniRuediger,1146720,1,2248,7,1148976
cricketnext,132126,2,1010260,217,1142605
rajesh9lessons,1569,0,1125549,4,1127122
rsn,873,0,1123670,14,1124557
mahdinmk,1386,0,1119790,109,1121285
RajAmbedkar650,244,0,1117330,179,1117753
SahilnDharia,520,0,1116359,11,1116890
ItsAnuEmmanuel,983669,6,121714,73,1105462
90sWWE,479143,2,613284,40,1092469
Zehra_Shaan,7682,0,1059050,27,1066759
MominaMustehsan,855464,1,211090,1,1066556
vidyaiyengarblr,361,0,1054130,2,1054493
OHCHR_MENA,199423,1,844448,97,1043969
LeherIndia,1677,1,1041398,83,1043159
hydroweaver,242,0,1036852,244,1037338
songdewnetwork,18312,1,1015419,72,1033804
imrealasim,724322,2,285547,297,1010168
iamharshbeniwal,964767,0,40177,13,1004957
kawasaki__aya,363663,0,631105,34,994802
IndrajitSasmal1,121,0,992549,0,992670
jasonnash,969879,1,20125,0,990005
MichaelaCoel,271901,3,714742,3,986649
nickbilton,249876,2,726801,39,976718
sinanantoon,31280,1,938970,42,970293
shwetasinghkirt,489208,4,472536,848,962596
vgcerf,33417,4,920301,23,953745
kennethdalglish,945611,0,4297,0,949908
CalumChambers95,872699,2,76292,24,949017
ChrisEriksen8,933394,4,12571,617,946586
ndennis_benn,6479,0,937159,136,943774
KranichHS,6925,2,934177,6,941110
viziandrei,6639,0,934048,46,940733
ZellnerLaw,750853,0,184151,0,935004
shahzerkhan,372,0,933633,434,934439
KayleeScott5,272,0,933242,46,933560
rehanasrehman,3041,0,914214,647,917902
SakshiMalik,531551,18,383756,4,915329
_4Programmer,8808,0,906116,160,915084
saloni_dilli,1407,0,899326,28,900761
johndoerr,291197,2,606005,14,897218
aroonpurie,109135,10,787190,5,896340
Ronaldo,877897,3,15709,1,893610
J_Gomez97,848936,4,41620,1,890561
BotJunkie,14179,0,869084,282,883545
ipriyanksharmaa,342864,1,534781,24,877670
PhilFoden,865116,2,305,2,865425
rush2yyz,1464,0,847318,9,848791
davutgoksu,821864,1,78,18,821961
AshokMaruthi,825,0,820703,2,821530
Gupta_ReenaG,2684,0,815748,54,818486
pksidharth10,1547,0,805961,25,807533
AbizaidAlfie,1223,0,805910,38,807171
DhanyaThoppil,644,0,805100,6,805750
svenphilipsen,38393,0,759885,5,798283
devonpj,786,0,796942,39,797767
gringreen,11556,0,785874,0,797430
migueldeicaza,86392,1,700760,304,787457
Ajitessh,290,0,779243,39,779572
pHatScoop,195,0,771771,92,772058
LievSchreiber,232683,0,529829,226,762738
Sagnaofficial,761771,5,207,45,762028
essarpetrolpump,6637,0,752694,1,759332
MarketsHill,3135,0,756121,9,759265
bpkFEARLESS,5962,0,751594,685,758241
mcl5tech,788,0,739826,33,740647
Joe_Nye,90822,3,644220,28,735073
ajayghayal,1301,0,733718,12,735031
sushmarajput12,506,1,723182,387,724076
fpfmusic,120614,0,594658,265,715537
NallagatlaPRao7,1189,0,713825,14,715028
MagnusCarlsen,644098,1,48316,9,692424
Gary_Kirsten,543359,5,139988,80,683432
jeanwanwan,678652,0,1048,191,679891
begusgasper,2594,0,675468,33,678095
stratechery,138325,3,536309,79,674716
TheBeerAnkur,6380,1,668218,1,674600
Meenzaa1805,463,0,671437,11,671911
patcummins30,590693,8,80536,10,671247
anjali_damania,116059,3,544570,16,660648
vikasbajaj,24927,0,617484,2,642413
BoniSatani,3885,2,631778,18,635683
SirScoots,55973,0,578650,14,634637
SingleForLifey,7172,0,622186,47,629405
jaymendiratta,519,0,623081,2,623602
UNDPDC,4893,0,611308,2,616203
MahuaMoitra,601523,11,13081,224,614839
year_progress,597008,0,11837,4,608849
OneStory_com,14796,0,592820,60,607676
gfiorelli1,43753,3,562945,95,606796
David_Eccles,2684,0,600150,4,602838
shagunsodhani,1533,0,600797,0,602330
pkgurgaon,11347,1,588929,159,600436
alexia,168353,4,424921,20,593298
nikhilesh7,364,0,589357,0,589721
CharlesRexha,1075,0,587787,61,588923
atulkannaujvi,963,0,579383,45,580391
shamsforjustice,2500,0,574757,343,577600
wefollow,566061,0,220,9,566290
abhishekaitc,559528,5,5400,84,565017
monishaadvani,6713,4,545268,141,552126
danielwilsonPZ,5381,1,543769,30,549181
danieldennett,306443,2,239495,1,545941
george_szirtes,15509,0,528449,40,543998
IAmMohdFarhan,427,0,541354,428,542209
Anupam_Guha,13954,0,528007,43,542004
DogeMocenigo,1289,0,533445,30,534764
bevyshopping,222,0,533666,20,533908
kittywenham,4464,0,528339,22,532825
addyosmani,308428,1,221046,1,529476
blackrock,517880,5,11379,16,529280
cyalm,269079,0,243508,4,512591
hdmoore,91164,2,421108,5,512279
ashulazy8,51,0,508750,3,508804
SQLCindy,3310,0,503507,106,506923
chelsailama,410,0,504789,6,505205
MikeLuttermoser,1230,0,499803,121,501154
DipaKarmakar,268696,8,224880,77,493661
manrajsgrover,783,0,491363,63,492209
ConorMurrayYT,2170,0,486422,12,488604
GulzarPoetry,182672,3,303496,38,486209
bipashabasusays,4297,0,479102,19,483418
AbouVDIABY,324637,0,158005,47,482689
Hindus4HR,7405,1,457431,23,464860
rgruia,12199,0,447631,316,460146
MarleeMatlin,415478,1,42461,17,457957
DendiBoss,448468,3,7812,14,456297
LifeMathMoney,284926,4,168424,1,453355
AstroBehnken,373623,7,74950,39,448619
sparker,378300,2,66768,0,445070
DonRickles,177861,3,261210,20,439094
SherwinBitsui,2916,0,434518,278,437712
SanjivReddi,1513,0,435764,151,437428
triptoes,11219,0,424375,2,435596
Rkbahadur1,581,0,431938,131,432650
ramhemmige,2725,0,423683,8,426416
dreamzdotcom,14581,0,407848,46,422475
RamsingPatil,239,0,417190,685,418114
samyra_md,1532,1,408438,43,410014
SicK_cs,244164,0,165205,106,409475
sptiwari97,36997,0,372403,8,409408
ASHISH225,3444,0,396419,80,399943
anandgopan,287,0,394261,59,394607
nik_lugi,4467,0,389283,58,393808
Trinitek,151,0,383185,14,383350
gitagovinda,3608,0,378977,24,382609
hochstenbach,1323,0,380851,30,382204
RonConway,106729,3,274709,41,381482
apurvadesai,596,0,377904,0,378500
Astro_Doug,337200,6,34954,41,372201
clouddirect,2886,0,368893,30,371809
wearelineate,6059,0,362985,14,369058
virendra79,16888,0,351585,2,368475
traceyvincel,21416,0,346764,2,368182
Nafeesmeah,405,0,366635,25,367065
Magpi_Mobile,2871,0,363045,0,365916
ilyasut,86833,4,274241,245,361323
mirianfrsilva,2395,0,357935,8,360338
MoPathGuy,3470,2,356533,0,360005
TEKKEN,150170,2,207851,121,358144
BillyRowley,431,0,354417,6,354854
kkmookhey,2793,3,349390,53,352239
MehrotraDPT,168,0,351919,20,352107
colors_infinity,93051,4,256157,8,349220
TheSarahLeBlanc,2239,0,344173,51,346463
nadiahijab,2660,0,343745,7,346412
The_Sleigher,45323,0,300247,3,345573
Steviegrieve,21741,2,315810,11,337564
sujit_kr_lucky,15207,0,322185,152,337544
leepace,284151,0,52279,10,336440
DwayneDuggerII,37029,0,296620,4,333653
ivivianrichards,187063,6,142050,196,329315
senaparna,216683,1,110777,107,327568
david_perell,319309,5,7195,12,326521
joebryantla,19791,0,306621,96,326508
mr_rcollins,7509,0,313314,99,320922
FardeenFKhan,318248,2,470,58,318778
coL_Sottle,14087,4,299309,1,313401
DeRubeisLab,841,1,310504,84,311430
anaa4321,1957,1,307274,1,309233
Indianbluebook,1281,0,299958,4,301243
HermiesTV,231,0,298932,895,300058
eveewing,236266,3,62321,341,298931
synthetix_io,206891,1,90257,2,297151
jayantgajria,918,0,291177,8,292103
PIBFactCheck,252847,2,37421,46,290316
GregGoralski,979,0,286911,96,287986
SameerSahoo,1352,0,285022,30,286404
Alok06897183,114,0,284318,14,284446
SadhviPragya_MP,211910,4,70716,304,282934
tarun_05,323,0,276937,6,277266
Hymnrael,1495,1,275549,29,277074
AniDave11,93,0,274821,28,274942
tristanwalker,265155,2,3145,6,268308
RootKanal,10911,0,254220,3,265134
vinaykamat,1844,0,260728,12,262584
Mebane92,104058,0,156774,142,260974
SebastianThrun,77351,3,182189,2,259545
ZhenggangZhu,792,0,256240,12,257044
BournvitaIndia,1513,3,248669,3,250188
TeezaJo,110,0,248709,10,248829
golu_a,1083,1,244121,44,245249
Imuskaan22,825,0,241650,9,242484
mgmnair,4884,0,235180,4,240068
BhimBassi,138281,3,101612,55,239951
NanoLiveLtd,3704,0,235283,8,238995
KikiMladenovic,215436,1,20529,26,235992
TMKOC_NTF,129578,0,104347,151,234076
DarrylHudspeth,36374,0,195609,14,231997
gautham_009,709,0,230348,0,231057
fadnavis_amruta,179196,3,50248,45,229492
NEVILLEBRAGANZA,200,0,227465,55,227720
sandeepm1,6152,3,214420,488,221063
Nanobiosym,1309,0,217347,1580,220236
SujitSe98018197,1201,0,218610,20,219831
LVSocialMedia,5447,0,212841,315,218603
TIENSindonesian,77668,0,138631,86,216385
PlantPolarity,673,0,215153,1,215827
rathsandeep,570,0,214534,270,215374
SweetInTheGale,2935,0,207142,7,210084
skilledinodisha,204206,3,557,1,204767
Nher_who,179788,0,24325,11,204124
omprakashrjd,6853,0,193654,182,200689
nrbnsntr,350,0,198114,63,198527
kalikapg,1008,0,195334,6,196348
AnamZille,824,0,194872,32,195728
TheSuhaniShah,13405,0,180486,115,194006
kellykellman,259,0,189835,19,190113
dkhos,122073,6,64653,4,186736
TanayaRamyani,287,0,183135,10,183432
Early_Salary,3078,0,177710,317,181105
pradeepsethi,32436,0,147058,289,179783
AnalyticsJamie,20242,0,158604,7,178853
SandeepAgg,173884,1,135,268,174288
TK_Tejan,579,0,172852,4,173435
DawnLSturgeon,3221,0,168696,1,171918
ipevo,31026,0,138519,31,169576
Nawneet,701,1,167743,6,168451
DrManishDiwan,924,3,167031,90,168048
yogidholakia,589,0,164679,10,165278
avinashtiw85,5991,1,159107,85,165184
antabra,1359,0,163237,38,164634
EmmaMayLondon,1412,0,162524,4,163940
levelsio,142714,2,16898,62,159676
InedibleBulk,1086,0,156419,12,157517
pillais,799,0,156208,9,157016
pc_of_az,2857,0,151178,29,154064
sarkaaridoc,2674,0,145543,136,148353
Backlinko,3697,7,142817,291,146812
AstroMCollins,94524,1,50214,34,144773
NashFargo,141597,1,2968,144,144710
FancyFootloose,655,0,141271,36,141962
nlpnoah,19175,1,121413,1,140590
stephen_wolfram,86264,5,52766,100,139135
deeptisawhney,1214,0,137790,52,139056
TanviSunku,220,0,134086,17,134323
meghnagulzar,114568,8,16586,17,131179
AmiitGautam,46,0,130746,64,130856
rakakhashu,1114,0,127408,31,128553
bose_joey,1180,0,126871,26,128077
megparikh,2351,1,121570,258,124180
am_aswad,122371,0,324,35,122730
parmeshbk,1171,0,117286,65,118522
DharaviDiary,1654,1,115894,24,117573
wpkofficial,100744,0,15524,430,116698
Guiyze,552,0,114295,17,114864
MirYanaSY,39810,0,71737,146,111693
atanudey,6361,0,103198,11,109570
RainaMIRROR,1304,0,106632,30,107966
frankhuzur,2586,0,104654,227,107467
dhiraj_d_bhatia,2470,1,104911,0,107382
Rescisco1,7531,0,98292,619,106442
GurpreetGhuggi,57563,5,48678,0,106246
MadhusudanKela,104198,0,1895,101,106194
Lorth,206,0,104785,6,104997
jnks77,805,0,103713,1,104519
rohitdbrijnath,5902,1,98084,67,104054
EnergyFirst,29768,0,73911,97,103776
mopatel,621,0,99424,0,100045
BadAssMonroex3,81,0,99844,0,99925
mkverma001,134,0,97450,10,97594
VNesH40YCnWRZng,2060,0,93922,1,95983
priyankashah92,600,0,94723,1,95324
alexstamos,90872,3,49,8,90932
lokeshbherwani,363,0,90403,38,90804
VarshabenDoshi,77083,0,11588,6,88677
DrHowardGardner,24944,1,61323,5,86273
ningarajbjp,3035,0,83002,136,86173
Cowboywriter1,2972,0,80107,0,83079
etokki,3445,0,79432,92,82969
mattpitman,6407,0,75996,161,82564
generativist,19805,2,60157,702,80666
EFNilesh1212,1150,1,79447,7,80605
Speaker_Central,120,0,79218,63,79401
Logistics_MoC,27726,0,50394,10,78130
sethuvij,2869,3,73910,1,76783
josephfcox,76364,3,132,69,76568
m2jr,74316,3,11,8,74338
GermannStefan,1633,0,72476,20,74129
charlielmo,18312,0,52124,812,71248
davewiner,67033,3,3162,24,70222
zafarkara,661,0,67815,49,68525
kathakalichanda,506,0,64879,143,65528
surajjagan,1352,1,62582,2,63937
DevonNewport,34842,0,28910,8,63760
anikgoel,4605,0,55785,1,60391
udaynirgudkar,21601,0,36780,4,58385
DineshG87963501,48,0,57596,53,57697
mattcohler,37846,3,18268,22,56139
ScalarHumanity,5888,0,48341,63,54292
dilnawazpasha,1808,1,52198,9,54016
conniechan,51461,1,1567,32,53061
JFemiCole,1794,0,50598,283,52675
sivavaid,35734,2,16281,12,52029
rajdoye,315,0,50761,19,51095
angad_virk,197,0,48809,275,49281
shobhitbanga,2988,0,46018,39,49045
lachygroom,16299,2,28835,34,45170
yournextpick,6022,0,38176,0,44198
chintan_acharya,1086,0,42062,237,43385
bcgoyette,3214,0,39355,100,42669
trufelman,37292,0,4967,14,42273
iamvasanth93,256,0,40664,43,40963
colddirt,745,0,39459,10,40214
smlungpathguy,25455,13,14474,0,39942
bobbyhollywood,354,0,38529,1,38884
AyushiBurman,79,0,36619,553,37251
SearchCandy,4586,0,32203,6,36795
Chitchitchit,7267,0,29131,166,36564
arnavahlu,178,0,36070,11,36259
modiabhishek,443,0,32617,49,33109
ArghaManna,514,1,31964,129,32608
mertkilickaya_,346,0,32162,5,32513
sidharth__am22,11866,0,20381,20,32267
knashok,136,0,31731,124,31991
soorajbhalla,287,0,30458,46,30791
Kush_Savani,211,0,30523,37,30771
Pallamrajumm,26866,1,628,9,27504
b_kleiban,3563,0,23556,94,27213
johnplattml,25093,0,1914,67,27074
Sree_Vijaykumar,859,0,25736,1,26596
prichronicles,1375,0,24740,0,26115
TTVaibhavam,2632,0,23123,239,25994
rohanjaitley,25722,3,10,9,25744
JRobbinsMD,2081,0,23642,0,25723
PCpicturesclub,21840,0,2786,6,24632
sanjaykhandduri,1416,0,22652,3,24071
Soundarya_J,728,0,21696,1,22425
atul_jalan,18165,0,4176,19,22360
freddyb,2502,1,19520,73,22096
StephanKast,20060,0,208,889,21157
Rancorinfotech,721,0,20311,7,21039
anilmdave,20830,4,0,67,20901
ohmary11,2495,0,17772,313,20580
IoTReadiness,3328,0,14712,70,18110
Sarojayeramilli,450,2,17519,24,17995
anandmamc,13918,0,3626,3,17547
karthik_econ,16630,0,267,1,16898
ArjunShukla_,7088,1,9076,1,16166
bennkuru,1216,0,14191,254,15661
FedericoCaivano,2499,0,11822,2,14323
hosain,9320,1,4272,0,13593
Kristi414US,124,0,13304,1,13429
MattBrittin,8926,0,4464,23,13413
IGorishThakur,12957,0,107,17,13081
theartofsaving,3946,0,8937,117,13000
cure53berlin,8451,1,3542,27,12021
InfiVivek,421,0,10191,25,10637
cloud4computing,2203,0,5908,2106,10217
patho_arshad,684,0,9482,9,10175
NYCITI_India,996,0,8065,62,9123
GeoffJosey,8034,0,143,180,8357
flora_2712,826,0,7037,17,7880
ENTpathology,5422,9,2263,39,7733
sheyllabs,3890,0,3150,483,7523
Suraj_S3,41,0,7227,32,7300
satishreddy_v,215,0,6966,52,7233
manishatrigs,999,0,5912,48,6959
MuxingAnalytics,1373,0,5445,13,6831
whotookadnan,628,0,6138,0,6766
Poonamc85363354,205,0,6259,2,6466
kavitarajwade,1147,0,4800,333,6280
HotRickshawLegs,904,0,3414,1731,6049
mattasimpson,1910,0,3794,216,5920
saum98,924,1,4932,24,5881
Armaanian_Aditi,722,0,4806,1,5529
vishaltv,178,0,5026,24,5228
dranujpa,368,0,4622,11,5001
TheTanayJain,283,0,4019,25,4327
GA_offcl,1168,0,492,11,1671
eleganzz,1237,1,123,0,1361
Joy_01,147,0,1002,16,1165
ef_shiv,1068,0,10,35,1113
DebSreeSarkar,874,0,4,4,882
Trans_NewYork,171,1,164,2,338
